#######
#    E#
# ### #
# #   #
# # ###
#S#   #
#######
