#########
#      E#
# # #####
# # #   #
# ### # #
#     # #
####### #
#S      #
#########
