###########
#S        #
######### #
#         #
# #########
# #       #
# ####### #
#         #
######### #
#        E#
###########
