###########
#S#       #
# # # ### #
# # # #   #
# # # # ###
# # # # # #
# ### # # #
#     #   #
######### #
#        E#
###########
