###########
#S#     # #
# # ### # #
# # #   # #
# # # ### #
# # # #   #
# # # ### #
#   #     #
######### #
#        E#
###########
