#########
#S    # #
##### # #
#   # # #
# # # # #
# # # # #
# ### # #
#      E#
#########
