#########
#      E#
# ##### #
# #   # #
# ### # #
#     # #
####### #
#S      #
#########
