###########
#S  # #   #
### # # # #
#   # # # #
# ### # # #
#   #   # #
### ##### #
# #     # #
# ##### # #
#        E#
###########
