###########
#S#       #
# # ### # #
# #   # # #
# ##### # #
#     # # #
##### # ###
#   # #   #
# ### ### #
#        E#
###########
