#############
#S# #       #
# # # ### ###
# #     #   #
# ######### #
# #       # #
# # ##### # #
#   #   # # #
##### # # # #
#     # # # #
# # ##### # #
# #        E#
#############
