#####
# #S#
# # #
#E  #
#####
