#########
#      S#
# #######
# #     #
# ### ###
#   #   #
### ### #
#E      #
#########
