#######
#    E#
##### #
#     #
# ### #
#S#   #
#######
