#####
#  S#
# ###
#E  #
#####
