#############
#S#         #
# # ####### #
# #     #   #
# # ### #####
# #   #     #
# ### ##### #
# # #   #   #
# # ### # ###
# #     #   #
# ######### #
#          E#
#############
