#############
#S        # #
######### # #
# #     #   #
# # # ##### #
# # #     # #
# # ##### # #
# # #   # # #
# # # # # # #
#   # # # # #
# ##### # # #
#       #  E#
#############
