#######
#S    #
### # #
# #T# #
# # # #
#     #
#######
===
#######
#     #
# ### #
# #T# #
#E# # #
#   # #
#######
