#########
#S#     #
# # # # #
# # # # #
# # # ###
# # #   #
# ##### #
#  T    #
#########
===
#########
#       #
# #####E#
# #     #
# #######
#       #
# ##### #
# #T    #
#########
