#########
#S###E  #
# ### # #
# ### #T#
# ### ###
# ### # #
# ### # #
#T###   #
#########
===
#########
#       #
### # # #
#   # #T#
# ### # #
# # # # #
# # # # #
#T#     #
#########
