#######
#S    #
##### #
#   # #
# # # #
#T#   #
#######
===
#######
#     #
# # # #
# #E# #
### # #
#T    #
#######
