#######
#S#   #
# # # #
#  T  #
##### #
#     #
#######
===
#######
#   E #
# ### #
# #T# #
# # # #
#   # #
#######
