#######
#S    #
##### #
#   #T#
# ### #
#E    #
#######
===
#######
#     #
# #####
#    T#
# ## ##
#     #
#######
