#########
#S###  T#
# ### # #
#T### # #
# ### # #
# ###  E#
#########
===
#########
#   #  T#
# # # # #
#T#   # #
### ### #
#       #
#########
