#############
#S  ###     #
### ### ### #
# #T### # #E#
# # ### # # #
# # ### # # #
# # ### # # #
# # ###T# # #
# # ##### # #
# # ###   # #
# # ### # # #
#   ### #   #
#############
===
#############
#           #
# ### ##### #
# #T#     # #
# # ##### # #
# # #     # #
# # ####### #
# #    T    #
# ###########
# #         #
# ##### ### #
#       #   #
#############
