#########
#S#     #
# # ### #
# # # # #
# # # # #
# #T  # #
# ##### #
#       #
#########
===
#########
# # E   #
# # ### #
#     # #
# ## ## #
# #T    #
# #######
#       #
#########
