#####
#S  #
# # #
# ET#
#####
===
#####
#   #
# # #
# #T#
#####
