#######
#S#   #
# # # #
# # #T#
# # # #
#E  # #
#######
===
#######
#     #
# ### #
# # #T#
# # # #
#     #
#######
