#########
#S      #
####### #
#    T# #
# # # # #
# # # # #
# # ### #
# #     #
#########
===
#########
# #     #
# # ### #
#   #T# #
# ### # #
#   # # #
### # # #
#  E#   #
#########
