###########
#S    #   #
##### ### #
#   #     #
# ####### #
#    T  # #
# ### ### #
# # # #   #
# # # # ###
#   #     #
###########
===
###########
#     #   #
# ### # # #
# # # # # #
# # # # # #
# # #T# # #
# # ### # #
#E#   # # #
# # # # # #
#   #   # #
###########
