###########
#S#       #
# # ##### #
# #     # #
# ####### #
#      T E#
######### #
#       # #
# # ##### #
# #       #
###########
===
###########
#   #     #
# # # # ###
# # # #   #
# ### ### #
#     #T# #
# ##### # #
# #   #   #
# ### #####
#         #
###########
