#######
#S#   #
# # ###
# #   #
# ### #
#  T  #
#######
===
#######
#E    #
# # # #
# # # #
# #   #
# #T# #
#######
