#####
#S  #
# # #
#  T#
#####
===
#####
#   #
# ###
#E T#
#####
