#########
#S#     #
# ##### #
#    T  #
####### #
#     # #
#E##### #
#       #
#########
===
#########
#       #
# ##### #
# # #T  #
# # #####
# #     #
# ##### #
#       #
#########
