#####
#S# #
#   #
#  T#
#####
===
#####
#  E#
# # #
#  T#
#####
