#########
#S      #
####### #
#     # #
# # ### #
# # #  T#
# ### ###
#       #
#########
===
#########
#   #   #
### # # #
#   # # #
# ### # #
#   # #T#
# # # ###
# #E    #
#########
