###########
#S        #
######### #
#     #T  #
# ### # ###
# #   # # #
# # ### # #
#E#   # # #
# ##### # #
#         #
###########
===
###########
#         #
# ####### #
# #    T# #
# # ##### #
# # #     #
# # ##### #
# #       #
# #########
#         #
###########
