###########
#S#       #
# # ##### #
# # #    T#
# # # #####
# # # #   #
# # # # ###
# # # #   #
# # # ### #
#   #     #
###########
===
###########
#   #     #
# # ### ###
#E# #   #T#
# # # # # #
# # # # # #
# # # ### #
# #   #   #
# ##### ###
#         #
###########
