#########
#S  #   #
### ### #
# #   #T#
# ### # #
# #   # #
# # ### #
# E     #
#########
===
#########
#       #
# ##### #
#     #T#
##### ###
#   # # #
# ### # #
#       #
#########
