##########
#S       #
# #### # #
# #    # #
# # #### #
# #      #
# ###### #
#       E#
##########