##########
#S       #
#   U    #
##########
===
##########
#   D    #
#      E #
##########