##########
#S       #
# #### # #
# #  U # #
# # #### #
# #      #
# ###### #
#        #
##########
===
##########
#   #### #
# #    # #
# # D  # #
# # ## # #
# #  U   #
# #### # #
#      # #
##########
===
##########
# E      #
# ###### #
# #      #
# # #### #
# # D    #
# ###### #
#        #
##########