##########
#S       #
# #### # #
# #  U # #
# # #### #
# #      #
# ###### #
#        #
##########