#######
#S   U#
#######
===
#######
#D   E#
#######