===
#######
#S    #
# ### #
#    T#
#######
---
#######
#T    #
# ### #
#    T#
#######
---
#######
#T    #
#  E  #
#     #
#######